11111111111111111
10C0P0010010001E1
10000001001000101
10000001001000101
11101001000000001
1C1010C000D000001
100000001001000E1
11111111111111111