1111111111111111111111111111111111
1E0000000000000C00000C000000000001
1010010100100000101001000000010101
1010P10010101010001001000000010101
100000000C00C00000000D0000000000C1
1111111111111111111111111111111111